5 8
########
#......#
#.#S#.##
##...###
########

3 3
###
#S#
###

12 12
############
#.#........#
#.######.#.#
#.#..##.#..#
#.#.#.....##
#...#S#.#.##
#.##..#.#.##
#.#.##..#..#
#.#...#.####
#.#####...##
#.......#..#
############